################################################################################
#..@...##......##..*...##......##......##......##......##......##.........#.+..#
#......##...*..##......##......##..*...........##..*...##......##..##.....#....#
#......##......##......##......##..............##......##......##..##..........#
#......##......##......##......##..............##......##......##..............#
#......##......##......##......##......##......##..............##..............#
#......##..............##......##......##......##..............##..##......#####
#......##..............##......##......##......##..............##..##......##..#
#......##..............##......##......##......##......##......##..............#
#......##......##......##......##......##......##......##......##..#....##...*.#
#......##......##......##......##......##......##......##......##.......##.....#
#......##......##......##......##......##......##......##......##..............#
#......##......##......##..............##......##......##......##..##....##....#
#......##......##......##..............##.....*##......##......##..##....##....#
#......##......##......##..............##......##......##......##..............#
#......##......##......##......##......##......##......##......##..#...##......#
#......##......##......##......##......##......##......##......##..#...##......#
#......##......##......##......##......##......##......##......##..............#
#......##......##......##......##......##......##......##......##..*.##....##..#
#......##......##......##......##......##......##......##......##....##....##..#
#......##......##......##......##......##......##......##......##..............#
#......##......##......##......##......##......##......##......##..............#
#......##......##......##......##......##......##......##......................#
#..............##......##......##......##......##......##......................#
#..............##......##......##......##......##......##.............####.....#
#..............##......##......##......##..............##......##.....####.....#
#......##......##..............##......##..............##.............####.....#
#......##......##..............##...*..##..............##......##..............#
#...*..##......##..............##......##..*...##......##......##.........*....#
################################################################################
